EQS = "countries/Equestria.txt"
PSP = "countries/Pegasopolis.txt"
URF = "countries/Unicorn_Revolutionary_Front.txt"
BLS = "countries/Bales.txt"
TSV = "countries/Trotsylvania.txt"
DWH = "countries/Dewhurst.txt"
SKS = "countries/Skystead.txt"
DAL = "countries/Albion.txt"
PRA = "countries/Prance.txt"
MHT = "countries/Manehattan.txt"
LST = "countries/LunarState.txt"
HCP = "countries/HoofProtectorate.txt"
HSM = "countries/HayseedMarches.txt"
DAC = "countries/Dalimare.txt"
STR = "countries/Stratusburg.txt"
DET = "countries/Detrot.txt"
FRI = "countries/Friesia.txt"
CDI = "countries/Dragon_commiserat.txt"
TTL = "countries/Teotltlali.txt"

OLE = "countries/Olenia.txt"
OLD = "countries/Cervus.txt"
VAR = "countries/Varian_Empire.txt"

CHN = "countries/Vraks.txt"
CHS = "countries/Soryth.txt"
CHR = "countries/Reisamm.txt"
CHD = "countries/Dytrisium.txt"
SEV = "countries/Severyana.txt"
YAK = "countries/Yakistan.txt"

CRY = "countries/CrystalEmpire.txt"
CRU = "countries/Umbrum_lands.txt"




